+--+--+--+--+--+--+--+--+--+  +--+--+--+--+--+--+--+--+--+--+--+--+--+--+--+--+--+--+--+--+--+--+--+--+--+--+--+--+--+--+
|                    |     |  |           |        |                 |                 |     |           |              |
+  +--+--+--+--+  +  +  +--+  +  +  +--+  +--+  +  +  +--+--+--+--+  +  +  +--+--+--+  +  +  +  +  +--+--+  +--+--+--+  +
|     |        |  |     |     |  |  |     |     |  |     |        |     |           |     |  |  |     |     |        |  |
+  +--+  +--+  +  +--+  +  +--+--+  +  +--+  +--+  +--+  +  +--+  +--+--+--+--+--+  +--+--+  +--+--+  +  +--+  +--+--+  +
|  |     |  |  |  |     |        |  |  |     |  |  |     |     |              |  |     |        |     |     |        |  |
+--+  +--+  +  +  +  +--+--+--+  +  +  +  +--+  +  +  +--+--+--+--+  +--+--+  +  +--+  +--+--+  +  +--+--+  +  +--+  +  +
|     |  |     |  |     |        |  |  |  |        |              |        |  |     |     |     |           |  |     |  |
+  +--+  +  +--+  +  +--+  +--+--+  +  +  +  +--+--+--+--+--+--+  +  +--+  +  +--+  +--+  +--+  +  +--+--+--+--+  +--+  +
|  |     |        |  |     |        |  |  |     |              |  |  |     |        |  |     |  |                 |     |
+  +  +--+--+--+--+  +  +--+--+--+  +  +  +--+  +  +  +--+--+--+  +--+  +--+--+--+  +  +--+  +  +--+--+  +--+--+--+  +--+
|  |                 |              |  |  |     |  |  |        |  |     |        |     |     |  |        |        |     |
+  +--+--+--+--+--+--+--+--+--+--+--+  +  +  +--+  +  +  +--+  +  +  +--+--+--+  +  +--+  +--+  +--+  +--+  +--+  +--+  +
|  |        |                          |  |        |  |     |  |     |           |  |     |        |     |  |           |
+  +  +--+  +  +--+--+--+--+--+--+--+--+  +--+--+--+--+--+  +  +--+--+--+  +--+--+  +  +--+--+--+  +--+--+  +--+--+--+--+
|  |  |  |  |  |        |        |        |        |     |  |              |     |  |        |  |        |     |        |
+  +  +  +  +  +--+  +  +--+--+  +  +  +  +  +--+  +  +  +  +--+  +--+--+--+  +  +  +--+--+  +  +--+--+  +  +  +  +--+  +
|  |  |  |  |     |  |        |     |  |  |     |     |        |              |  |        |  |           |  |     |     |
+  +  +  +  +--+  +  +--+--+  +--+--+  +  +--+  +--+--+--+--+--+--+--+--+  +--+  +  +--+--+  +  +--+--+--+--+--+--+  +--+
|        |  |     |  |     |        |  |     |     |                    |     |     |     |  |                    |     |
+--+--+--+  +  +--+  +  +  +--+--+  +  +--+  +--+  +  +--+--+--+--+--+  +--+  +--+--+  +  +  +--+--+--+--+--+--+  +--+  +
|           |  |     |  |        |  |     |     |  |        |     |     |     |        |  |     |        |     |  |     |
+  +--+--+  +  +--+  +--+  +--+--+  +  +  +  +--+  +--+--+  +--+  +  +--+--+--+  +--+--+  +--+  +  +--+  +  +  +  +  +--+
|  |     |  |     |     |        |  |  |  |  |     |     |     |     |           |     |     |     |     |  |     |     |
+  +  +  +--+--+  +--+  +  +--+  +  +  +  +  +  +--+  +--+--+  +  +--+--+  +--+--+  +  +--+  +--+--+  +--+  +--+--+--+  +
|     |        |        |     |     |  |  |  |        |        |           |        |     |           |     |           |
+  +--+--+  +  +--+--+--+--+  +--+--+  +  +--+--+--+  +  +--+--+--+--+--+--+  +--+--+--+  +--+--+--+--+  +--+--+  +--+--+
|  |     |  |              |  |     |  |     |        |     |        |     |  |        |     |        |        |        |
+  +  +  +  +  +  +--+--+--+  +  +  +--+  +  +  +--+--+  +  +  +--+  +  +  +  +  +--+  +--+  +--+  +--+--+--+  +  +--+  +
|  |  |  |  |  |  |           |  |     |  |     |     |  |  |  |  |     |     |     |     |     |              |  |     |
+--+  +  +--+  +  +  +--+--+--+  +--+  +--+--+--+  +  +--+  +  +  +--+--+--+--+--+  +--+  +  +  +  +--+--+--+--+  +  +  +
|     |        |  |  |              |  |     |     |     |  |  |        |  |        |  |  |  |  |     |           |  |  |
+  +  +--+--+--+--+  +  +--+--+--+  +  +  +  +  +--+--+  +  +  +--+  +  +  +  +--+--+  +  +--+  +--+  +  +--+--+--+  +  +
|  |  |           |  |           |  |     |  |  |     |  |  |     |  |     |     |        |     |     |  |        |  |  |
+  +--+  +--+--+  +  +--+--+--+  +  +--+--+  +  +--+  +  +  +--+  +  +  +--+--+  +  +--+--+  +--+  +--+--+  +--+  +  +--+
|     |  |        |     |     |  |  |        |     |     |     |  |  |  |        |  |        |  |  |        |     |     |
+  +  +  +  +--+  +--+  +--+  +  +  +  +--+--+  +  +  +--+--+  +  +  +--+  +--+--+  +--+  +--+  +  +  +--+--+  +--+  +  +
|  |  |  |  |        |     |     |  |  |     |  |  |  |        |  |     |     |  |        |     |     |     |  |     |  |
+--+  +  +  +--+--+--+--+  +--+--+  +  +  +  +--+  +  +  +--+--+  +--+  +--+  +  +--+--+--+  +  +--+--+--+  +  +--+--+  +
|     |  |              |           |     |     |  |  |        |           |  |        |     |           |  |           |
+  +--+  +--+--+--+--+  +--+--+--+--+--+--+--+  +  +  +--+  +  +--+--+--+  +  +  +--+  +  +  +--+--+--+  +  +--+--+--+  +
|  |     |           |     |                 |     |     |  |           |  |  |     |     |           |        |        |
+  +  +--+  +--+--+  +--+  +  +--+--+  +--+--+--+--+--+  +--+  +--+--+--+  +  +--+  +--+--+--+--+--+  +--+--+  +  +--+--+
|  |  |        |        |     |  |     |              |     |        |     |     |        |     |     |     |  |  |     |
+  +  +--+--+--+  +--+  +--+--+  +  +--+  +--+--+--+  +--+  +--+--+  +  +--+--+  +--+--+  +  +  +  +--+  +  +--+  +  +  +
|  |              |  |     |     |        |        |     |  |     |           |     |  |     |  |        |  |     |  |  |
+  +--+--+--+--+--+  +--+  +  +  +--+--+--+--+--+  +  +--+  +  +  +--+--+--+--+--+  +  +  +--+--+--+--+--+  +  +--+  +  +
|           |     |  |     |  |                 |  |        |  |  |     |     |     |     |              |  |  |     |  |
+  +  +--+  +  +  +  +  +--+--+--+--+--+--+  +  +  +--+--+--+  +  +  +  +  +  +  +--+--+  +  +--+--+--+  +  +  +  +--+  +
|  |     |     |     |     |                 |     |  |        |     |     |  |        |  |     |     |     |     |     |
+  +--+  +--+--+--+--+--+  +  +--+--+--+--+--+--+  +  +  +  +--+--+--+--+--+  +  +--+  +  +--+  +  +  +--+  +--+--+  +--+
|     |  |        |        |  |        |           |     |     |  |           |  |     |     |  |  |        |     |     |
+  +--+  +  +--+  +  +--+--+  +  +--+  +--+  +--+--+--+  +--+  +  +  +--+--+--+--+  +--+--+  +  +--+--+--+  +--+  +--+  +
|  |     |  |     |  |     |     |  |     |     |     |     |  |  |  |              |     |  |     |     |     |     |  |
+  +  +  +  +  +  +  +  +  +  +--+  +--+  +--+  +  +  +--+--+  +  +  +--+--+  +  +--+  +--+  +--+  +  +  +--+  +--+  +  +
|  |  |  |  |  |  |  |  |  |           |  |     |  |        |  |  |        |  |  |           |     |  |  |  |  |     |  |
+  +  +  +  +  +--+  +--+  +--+  +--+--+  +  +--+  +--+--+  +  +  +--+--+  +  +  +--+--+--+--+  +  +  +  +  +  +  +  +  +
|  |  |  |  |     |     |        |     |  |        |     |  |  |        |  |  |     |           |  |  |  |        |  |  |
+  +  +--+  +--+  +--+  +--+--+--+  +  +  +--+--+--+  +--+  +  +--+--+  +  +--+  +  +  +--+--+  +--+  +  +--+--+--+  +  +
|  |        |     |     |        |  |  |     |     |     |  |        |        |  |  |     |     |     |     |     |  |  |
+--+--+--+--+  +  +  +--+  +--+  +  +  +--+  +  +--+  +  +  +  +--+  +--+--+  +--+  +  +  +--+--+  +--+--+  +  +--+  +  +
|              |  |  |     |  |     |     |  |        |     |     |     |  |     |  |  |        |  |        |        |  |
+  +--+--+--+  +--+  +--+  +  +--+--+--+  +  +--+  +--+--+--+--+  +--+  +  +--+  +  +  +--+--+  +  +  +--+--+--+--+--+  +
|        |     |     |     |        |     |     |  |     |     |     |  |        |  |        |     |  |           |     |
+  +--+  +--+--+  +--+  +--+  +--+--+  +--+--+  +  +  +  +--+  +--+  +  +--+--+  +  +--+  +--+--+--+  +  +--+--+  +  +--+
|     |        |  |        |                    |     |     |        |        |     |     |        |     |     |     |  |
+--+  +--+--+  +  +--+--+  +  +--+--+--+--+--+--+--+--+--+  +--+  +--+--+  +  +--+  +--+--+  +--+  +--+--+  +  +  +--+  +
|  |        |     |     |  |  |           |           |  |     |  |     |  |     |  |        |  |           |  |  |     |
+  +--+--+  +--+--+  +  +  +--+  +--+--+  +--+  +--+  +  +--+  +--+  +  +  +--+  +  +  +--+--+  +--+--+--+--+  +  +--+  +
|  |     |           |  |        |        |     |  |  |     |  |     |  |     |  |  |  |        |              |        |
+  +  +  +--+--+--+--+  +--+  +--+  +--+--+  +--+  +  +  +  +  +  +--+  +--+  +  +  +  +  +  +  +  +--+--+--+--+--+--+  +
|  |  |              |     |     |  |        |           |  |     |  |  |     |  |  |  |  |  |  |     |              |  |
+  +  +  +  +--+--+--+--+  +--+--+  +  +  +--+--+--+--+  +--+--+--+  +  +--+  +  +--+  +--+  +  +--+  +--+  +--+--+--+  +
|     |  |  |     |     |           |  |     |        |  |           |     |  |     |  |     |  |     |     |     |     |
+  +--+  +--+  +  +  +  +--+--+--+--+  +--+  +  +--+  +--+  +--+  +--+--+  +--+--+  +  +  +--+  +  +--+  +--+  +  +  +--+
|  |  |     |  |     |        |        |     |  |     |     |  |        |  |     |        |     |  |  |     |  |  |     |
+  +  +--+  +  +--+--+--+  +  +  +--+--+  +  +  +  +--+  +--+  +--+  +--+  +  +  +--+--+--+--+--+  +  +  +  +  +  +--+  +
|  |     |  |  |     |     |  |  |        |  |  |        |     |  |        |  |     |     |        |     |     |  |     |
+  +  +  +  +  +  +  +  +--+--+  +  +--+--+--+  +--+--+--+  +  +  +--+--+--+  +--+  +  +  +  +--+--+  +--+--+--+  +  +--+
|     |  |        |  |           |                          |                 |        |     |                 |        |
+--+--+--+  +--+--+--+--+--+--+--+--+--+--+--+--+--+--+--+--+--+--+--+--+--+--+--+--+--+--+--+--+--+--+--+--+--+--+--+--+

